0 0 0 4 0 0 0 0 0 0 0 0 0 0 0 0 0 0 0 0 0 0 0 0 0 0 0 2
2 6 6 1 6 6 2 0 0 0 0 0 0 0 0 0 0 4 0 0 0 0 0 0 0 0 0 2
2 0 0 0 0 0 2 0 0 0 0 2 1 1 1 1 1 1 1 1 1 2 0 4 0 0 0 2
2 0 4 0 0 0 2 0 0 0 0 2 0 0 0 0 0 0 0 0 0 2 1 1 1 1 1 2
2 1 6 1 6 1 2 0 0 0 0 2 0 0 0 0 0 0 0 0 0 2 0 0 0 0 0 0
2 0 0 0 0 0 2 3 3 3 3 2 3 3 3 3 3 3 0 0 0 2 0 0 0 0 0 0
2 0 0 0 0 0 2 0 0 0 0 2 0 0 0 0 0 2 1 1 1 6 6 6 6 6 6 2
2 0 0 0 0 0 2 0 0 0 0 2 0 0 4 0 0 2 0 0 0 0 0 0 0 0 0 2
2 0 0 0 0 0 2 0 4 0 0 2 1 1 1 1 1 2 0 0 0 0 0 0 0 0 0 2
6 1 1 1 6 1 1 6 1 1 6 2 0 0 0 0 0 0 0 0 0 2 1 1 1 2 1 1
6 1 1 1 6 0 0 0 0 0 0 2 0 0 0 0 0 0 0 0 0 2 0 0 0 2 0 0
6 0 4 0 6 0 0 0 0 0 0 2 0 0 0 3 3 3 3 3 3 2 0 0 0 2 0 4
1 1 1 1 1 1 1 1 2 1 1 1 6 6 6 6 0 0 0 0 0 2 0 0 1 1 1 1
0 0 0 0 0 0 0 0 2 0 0 0 0 0 0 0 0 0 0 0 0 2 0 0 0 0 0 0
0 0 0 0 0 0 0 0 2 0 0 0 0 0 0 0 0 0 0 0 0 2 0 0 0 0 0 0
1 1 1 1 1 1 1 1 1 1 1 1 1 1 1 1 1 1 1 1 1 1 1 1 1 1 1 1
6 6 6 6 6 6 6 6 6 6 6 6 6 6 6 6 6 6 6 6 6 6 6 6 6 6 6 6
5 18
14 14
3
3 3
5 18
8 6
