1 1 1 1 1 1 1 1 1 1 1 1 1 1 1 0 0 0 0 0 0 0 0 0 0 0 0 0
1 0 0 0 0 0 0 0 0 0 0 0 0 0 1 0 0 0 0 0 0 0 0 0 0 0 0 0
1 0 3 3 3 3 3 3 3 3 3 3 3 3 2 2 1 1 1 1 1 1 1 4 0 0 0 0
1 0 0 0 4 0 0 0 0 0 0 0 0 0 2 1 0 0 4 0 0 1 0 1 3 3 3 2
1 0 0 0 0 0 0 0 0 0 0 0 0 0 2 1 0 0 0 0 0 1 0 1 0 0 0 2
1 2 1 1 1 1 1 1 2 6 6 6 6 6 6 1 6 6 0 0 0 2 0 0 1 1 0 2
1 2 0 0 0 0 0 0 2 0 0 0 0 0 0 1 1 1 0 0 0 2 0 0 0 0 0 2
1 2 0 0 0 0 0 0 2 3 3 3 3 3 3 3 0 0 0 0 0 1 2 0 0 0 0 2
1 2 0 0 4 1 1 1 2 0 0 0 0 0 0 1 1 1 1 1 1 1 2 0 0 0 2 1
1 2 0 0 1 1 0 1 2 0 0 0 0 1 1 1 0 0 0 0 0 1 2 1 1 1 1 1
1 2 0 0 1 0 0 1 2 0 0 4 1 1 4 1 0 4 4 0 0 1 2 1 1 0 1 1
1 2 1 1 0 0 0 1 2 0 0 1 1 0 0 1 1 1 1 1 1 1 2 1 0 1 0 1
1 2 1 0 0 0 0 1 2 0 1 1 0 0 0 1 3 3 3 3 3 1 2 1 1 0 1 1
1 2 0 0 0 0 0 2 2 2 1 0 0 0 0 1 0 0 4 0 0 1 2 1 4 1 0 1
1 2 0 0 0 0 0 2 1 2 0 0 0 0 0 0 0 0 0 0 0 1 2 1 1 0 1 1
1 1 1 1 1 1 1 1 1 1 1 1 1 1 1 1 1 1 1 1 1 1 1 1 1 1 1 1
6 6 6 6 6 6 6 6 6 6 6 6 6 6 6 6 6 6 6 6 6 6 6 6 6 6 6 6
3 25
14 10
3
4 7
1 20
7 19
