0 0 0 0 0 0 0 0 0 0 0 0 0 0 0 0 0 0 0 0 0 0 0 0 0 0 0 0
0 0 0 0 0 0 0 0 0 0 0 0 0 0 0 0 0 0 0 0 0 0 0 0 0 0 0 0
0 0 0 0 0 0 0 0 0 0 0 0 0 0 0 0 0 0 0 0 0 0 0 0 0 0 0 0
0 0 0 0 0 0 0 0 0 0 0 0 0 0 0 0 0 0 0 0 0 0 0 0 0 0 0 0
0 0 0 0 0 0 0 0 0 0 0 0 0 0 0 0 0 0 0 0 0 0 0 2 6 6 6 0
0 0 0 0 0 0 0 0 0 0 0 0 0 0 0 0 0 0 0 0 0 0 0 2 0 0 0 0
0 0 0 2 6 6 6 6 0 0 0 0 0 0 2 6 6 6 6 6 6 6 0 2 0 0 0 0
0 0 0 2 0 0 0 0 3 3 3 3 3 0 2 0 0 0 0 0 0 6 0 2 0 0 0 0
0 0 0 2 0 0 0 0 0 0 0 0 0 2 1 0 0 0 0 0 0 6 0 2 0 0 0 0
0 2 1 2 0 0 0 0 1 1 1 1 0 2 0 0 0 0 0 0 0 6 0 2 0 0 0 0
0 2 0 0 0 0 0 0 2 0 0 0 0 1 0 0 0 0 0 0 0 0 6 6 0 0 0 0
2 1 3 3 3 3 3 3 2 0 0 3 3 3 3 3 3 3 3 3 3 3 3 3 0 0 0 0
2 0 0 0 0 6 0 0 2 0 0 0 0 0 0 0 0 0 0 0 0 0 0 1 1 1 2 2
2 1 1 1 0 6 0 0 0 1 1 1 0 0 0 0 0 0 0 0 0 0 0 0 0 0 2 2
2 0 4 0 0 6 0 0 0 0 0 0 0 0 0 0 0 0 0 0 0 0 0 0 0 0 2 2 
1 1 1 1 1 1 1 1 1 1 1 1 1 1 1 1 1 1 1 1 1 1 1 1 1 1 1 1
6 6 6 6 6 6 6 6 6 6 6 6 6 6 6 6 6 6 6 6 6 6 6 6 6 6 6 6
3 25
14 10
3
4 7
3 17
9 21
