0 0 0 0 0 0 0 0 0 0 0 0 0 0 0 0 0 0 0 0 0 0 0 0 0 0 0 0
0 0 0 0 0 0 3 3 3 3 3 3 3 3 3 3 0 3 3 3 3 0 0 0 0 0 0 0
0 0 1 1 1 1 1 0 0 0 0 0 0 0 0 0 2 0 0 0 1 1 1 1 1 1 0 0
0 0 1 4 0 0 1 0 0 0 0 0 0 0 0 0 2 0 0 0 1 0 0 0 0 1 0 0
0 0 1 1 0 0 1 0 0 0 0 0 0 0 0 0 2 0 0 0 1 0 0 0 0 1 0 0
0 0 1 4 0 0 1 0 0 0 0 0 0 0 0 0 2 0 0 0 1 0 0 0 0 1 0 0
0 0 1 1 1 0 1 0 0 0 0 0 0 0 0 0 2 0 0 0 1 0 0 1 1 1 0 0
0 0 0 0 0 0 0 0 0 0 0 0 0 0 0 0 2 0 0 0 0 0 0 0 0 0 0 0
0 0 0 0 0 0 0 0 0 0 0 0 0 0 0 0 2 0 0 0 0 0 0 0 0 0 0 0
1 1 1 1 1 1 1 2 0 0 0 0 2 1 1 1 1 1 1 1 2 0 0 0 0 0 0 0
1 0 0 0 0 0 1 2 0 0 0 0 2 1 0 0 0 0 0 1 2 0 0 0 0 0 0 0
1 0 0 0 0 0 1 2 0 0 0 0 2 1 0 0 0 4 0 1 2 0 0 0 0 0 0 0
1 1 1 1 1 0 1 2 0 0 0 0 2 1 0 0 0 1 0 1 2 0 0 0 0 0 0 0
1 1 0 4 1 0 1 2 0 0 0 0 2 1 0 0 2 0 0 1 2 0 0 0 0 0 0 0
1 1 1 1 2 0 2 2 0 0 0 0 2 2 0 4 2 0 0 2 2 0 0 0 0 0 0 0
1 1 1 1 1 1 1 1 1 1 1 1 1 1 1 1 1 1 1 1 1 1 1 1 1 1 1 1
6 6 6 6 6 6 6 6 6 6 6 6 6 6 6 6 6 6 6 6 6 6 6 6 6 6 6 6
5 24
8 3
3
4 7
7 17
9 21
